%%%%%%%%%%%%%%%%%%%%
%.    .      .    .%
%.%%.%.%%%%%%.%.%%.%
%......      ......%
% %%%%%%%%%%%%%%%% %
%       13%%24     %
%%%%%%%%%%%%%%%%%%%%
